usa - us - u.s. - u.s.a - america - american - americans - the united states - 'murica - the states 
russia - russian - russian federation 
mexico - mexican
duo - duolingo 
france - french - french republic 
italy - italian - italia
cali - california 
philly - philadelphia 
met gala - the met gala 
joe - biden 
google - goog 
rocket lab - rocketlab - rklb 
jerome powell - powell - jpow 
ufp technologies - ufpt 
warren buffet - warren buffett - buffet - buffett 
hitler - adolf
coca cola - cola - coca-cola company 
usmc - marine corps - us marine corps - u.s. marine corps - marine 
canada - canadian - the great white north
china - chinese - people's republic of china - prc - mainland china
baldur - balder's gate - baldurs gate - baldur's gate 
korea - korean
bitcoin - btc
nicolas cage - nick cage - nic cage
tesla - tsla
republican - GOP - republicans
elon - musk 
donald - trump 
constitution - the constitution - the constitution of the united states - the us constitution - us constitution - the constitution of the us 
dnc - democrat - democrats - dems 
microsoft - msft 
australia - australian - aussie 
jennifer lawrence - jlaw 
anakin - skywalker 
obi wan - obi-wan kenobi - kenobi 
south america - south american 
north america - north american 
africa - african 
asia - asian 
europe - european 
middle east - middle eastern 
afghanistan - afghan
albania - albanian
algeria - algerian
andorra - andorran
angola - angolan
antigua - antiguan
barbuda - barbudan 
argentina - argentine - argentinian - argentine republic
kingdom of the netherlands - netherlands - holland - dutchland
armenia - armenian
australia - australian - commonwealth of australia - oz 
austria - austrian
azerbaijan - azerbaijan - azeri
bahamas - bahamian
bahrain - bahraini
bangladesh - bangladeshi
barbados - barbadian
belarus - belarusian
belgium - belgian
belize - belizean
benin - beninese
bhutan - bhutanese
bolivia - bolivian
bosnia - bosnian
herzegovina - herzegovinian
botswana - motswana - batswana 
brazil - brazilian - brasil 
brunei - bruneian
bulgaria - bulgarian
burkina faso - burkinabé
burundi - burundian
cabo verde - cabo verdean
cambodia - cambodian
cameroon - cameroonian
central african republic - central african
chad - chadian
chile - chilean
colombia - colombian
comoros - comoran - comorian
congo - congolese - congolese
costa rica - costa rican
croatia - croatian
cuba - cuban
cyprus - cypriot
czech republic - czech
denmark - danish - kingdom of denmark 
djibouti - djiboutian
dominica - dominican
dominican republic - dominican
east timor - timorese
ecuador - ecuadorian
egypt - egyptian
el salvador - salvadoran
equatorial guinea - equatorial guinean
eritrea - eritrean
estonia - estonian
eswatini - swazi
ethiopia - ethiopian
fiji - fijian
finland - finnish
france - french
gabon - gabonese
gambia - gambian
georgia - georgian
germany - german - federal republic of germany - deutschland
ghana - ghanaian
greece - greek - hellenic republic
grenada - grenadian
guatemala - guatemalan
guinea - guinean
guinea-bissau - bissau-guinean
guyana - guyanese
haiti - haitian
honduras - honduran
hungary - hungarian
iceland - icelandic
india - indian - republic of india - bharat 
indonesia - indonesian - republic of indonesia 
iran - iranian - islamic republic of iran - persia
iraq - iraqi
ireland - irish
israel - israeli
italy - italian
jamaica - jamaican
japan - japanese - nippon - nihon
jordan - jordanian
kazakhstan - kazakhstani
kenya - kenyan
kiribati - i-kiribati
north korea - north korean - democratic people’s republic of korea - dprk
south korea - south korean - republic of korea - rok
kosovo - kosovar
kuwait - kuwaiti
kyrgyzstan - kyrgyzstani
laos - lao, laotian
latvia - latvian
lebanon - lebanese
lesotho - basotho
liberia - liberian
libya - libyan
liechtenstein - liechtensteiner
lithuania - lithuanian
luxembourg - luxembourgish
madagascar - malagasy
malawi - malawian
malaysia - malaysian
maldives - maldivian
mali - malian
malta - maltese
marshall islands - marshallese
mauritania - mauritanian
mauritius - mauritian
mexico - mexican
micronesia - micronesian
moldova - moldovan
monaco - monégasque
mongolia - mongolian
montenegro - montenegrin
morocco - moroccan
mozambique - mozambican
myanmar - burmese
namibia - namibian
nauru - nauruan
nepal - nepali
netherlands - dutch
new zealand - new zealander - nz - aotearoa
nicaragua - nicaraguan
niger - nigerien
nigeria - nigerian
north macedonia - macedonian
norway - norwegian - kingdom of norway 
oman - omani
pakistan - pakistani
palau - palauan
palestine - palestinian
panama - panamanian
papua new guinea - papua new guinean
paraguay - paraguayan
peru - peruvian
philippines - filipino
poland - polish
portugal - portuguese
qatar - qatari - state of qatar 
romania - romanian
russia - russian
rwanda - rwandan
saint kitts - kittitian
nevis - nevisian
saint lucia - saint lucian
saint vincent - saint vincentian
samoa - samoan
san marino - sammarinese
sao tome and principe - são toméan
saudi arabia - saudi - ksa - kingdom of saudi arabia
senegal - senegalese
serbia - serbian
seychelles - seychellois
sierra leone - sierra leonean
singapore - singaporean
slovakia - slovak
slovenia - slovenian
solomon islands - solomon islander
somalia - somali
south africa - south african - republic of south africa - rsa
south sudan - south sudanese
spain - spanish - kingdom of spain - españa
sri lanka - sri lankan
sudan - sudanese
suriname - surinamese
sweden - swedish - kingdom of sweden 
switzerland - swiss
syria - syrian
taiwan - taiwanese
tajikistan - tajikistani
tanzania - tanzanian
thailand - thai
togo - togolese
tonga - tongan
trinidad - trinidadian
tobago - tobagonian 
tunisia - tunisian
turkey - turkish - republic of türkiye
turkmenistan - turkmen
tuvalu - tuvaluan
uganda - ugandan
ukraine - ukrainian
united arab emirates - emirati - uae - emirates
united kingdom - britain - uk - great britain - england - british
united states - american
uruguay - uruguayan
uzbekistan - uzbekistani
vanuatu - ni-vanuatu
vatican city - vaticanian - vatican city state - vatican - holy see
venezuela - venezuelan
vietnam - vietnamese
yemen - yemeni
zambia - zambian
zimbabwe - zimbabwean
the new york times - nyt
massachusetts institute of technology - mit
university of california, berkeley - uc berkeley - cal
bitcoin - btc
ethereum - eth
chatgpt - openai's chatbot - gpt-4 chatbot
world bank group - world bank
meta platforms inc. - meta 
national aeronautics and space administration - nasa
federal bureau of investigation - fbi
wikipedia - wiki
reddit - reddit.com - the front page of the internet
tiktok - douyin
snapchat - snap
twitter - x - twitter.com
youtube - you tube - yt - youtube.com
the coca-cola company - coca-cola - coke
the walt disney company - disney
american telephone and telegraph company - at&t
general electric company - ge
united states congress - us congress - u.s. congress - congress
nintendo of america - nintendo 